GGKKKKKKKKKKKKGG
GGKGGGGGGGGGGKGG
GGKGRRRRRRRRGKGG
GGKGRKKKKKKRGKGG
GGKGRKRRRRKRGKGG
GGKGRKRRRRKRGKGG
GGKGRKKKKKKRGKGG
GGKGRRRRRRRRGKGG
GGKGGGGGGGGGGKGG
GGKKKKKKKKKKKKGG
