GGGKKGGGRRRRRGGG
GGKKGGGRRGGGRRGG
GKKGGGRRGGKGGRRG
KKGGGRRGGKKKGGRR
KGGGRRGGKKGKKGGR
GGGRRGGKKGRGKKGG
KGGGRRGGKKGKKGGR
KKGGGRRGGKKKGGRR
GKKGGGRRGGKGGRRG
GGKKGGGRRGGGRRGG
