KKKKKKKRRRRRRRRR
KRRRKKKGKKKGRRRR
KRRRGGGGKKKGGGGG
KGGGRRRRRRRGGGGG
KGGGRRRRRRRGGGGG
KKKKKKKKKKKKKKKK
GGGGRRRKKRRRKKKK
GGGGRRRKKRRRKKKK
RRRRGGGKKKKKKGGG
RRRRGGGKKKKKKGGG
