KKKKKGGGGGGGGGGG
KKKKKGGGGGGGGGGG
KKKGGGGGGGGGGGGG
KKGKKRRRRRRRRGGG
KKGKKRRRRRRRRGGG
RRGRRKKKKKKRRGGG
RRGRRKKKKKKRRGGG
RRRGGGGGGKKRRGGG
RRRRRGGGGKKRRGGG
RRRRRGGGGKKRRGGG
