KKKKKKKKKKKKKKKK
KRRRRRRRKKKKKGGK
KRKKKKKRKKKKKGGK
KRKRRRKRKKKKKKKK
KRKRGRKRKKGGGGGK
KRKRGRKRKKGKKKGK
KRKRRRKRKKGKRKGK
KRKKKKKRKKGKKKGK
KRRRRRRRKKGGGGGK
KKKKKKKKKKKKKKKK
