RRRRRRWWWYYRRRRR
RRRRRRWWWYYRRRRR
RRRRRRWWWYYRRRRR
RRRRRRWWWYYRRRRR
RRRRKRWWWYYRRRRR
RRRKKRWWWYYRRRRR
RRKKKKKKKKKKKKRR
RRRKKRWWWYYRRRRR
RRRRKRWWWYYRRRRR
RRRRRRWWWYYRRRRR
