KKKKKKKRRRRRRRRR
KRRRKKKYWWWYRRRR
KRRRYYYYWWWYYYYY
KYYYRRRRRRRYYYYY
KYYYRRRRRRRYYYYY
KKKKWKKKKKKKKKKK
YYYYRRRKKRRRKKKK
YYYYRRRKKRRRKKKK
RRRRYYYKKKKKKWWW
RRRRYYYKKKKKKWWW
