KKKKKKKKKKKRKKKK
KKKKKKKKKKRKKKKK
KKKKKKKKKRKKKKKK
KKKKKKKKWKKKKKKK
KKKKKKKRKKKKKKKK
KKKKKKRKKKKKKKKK
KKKKKRKKKKKKYKYK
KKKKRKKKKKKKKYKK
KKKRKKKKKKKKYKYK
KKRKKKKKKKKKKKKK
