YYYYYRKKKKRYYYYY
YRRWRRKKKKRRWRRY
YRRWRKKKKKKRWRRY
YWWYRYYWWYYRYWWY
YKKKYKKRRKKYKKKY
YKKKYKKRRKKYKKKY
KWWYKYYWWYYKYWWK
YRRWKKKKKKKKWRRY
KRRWKKKKKKKKWRRK
KKYKYKKKKKKYKYKK
