YYYYYRKWWKRYYYYY
YRRWRRKWWKRRWRRY
YRRWRKKKKKKRWRRY
YWWYRYYWWYYRYWWY
YKKKYKKRRKKYKKKY
YKKKYKKRRKKYKKKY
KWWYKYYWWYYKYWWK
YRRWKKKKKKKKWRRY
KRRWKKKYYKKKWRRK
WKYKYKYYYYKYKYKW
