RRRRRBBBBBBBBBBB
RRRRRBBBOOOBRRRB
BRRRBBBBOBOBRBRB
BBRBBBBBOBOBGBRB
BBRBGGGBOBGBGBRB
BBRBGBGBOBGGGBRB
BRRBGBGBOBBBBBRB
BRBBGBGBGBBBBRRR
BRRRGBGGGBBBRRRR
BBBBBBBBBBBBRRRR
