RBBBRBBBBBBBBBBB
RRBRRBBBOOOBRRRB
BRRRBBBBOBOBRBRB
BBRBBBBBOBOBGBRB
BBRBGGGBOBGBGBRB
BBRBGBGBOBGGGBRB
BRRBGBGBOBBBBBRB
BRBBGBGBGBBBBRRR
BRRRGBGGGBBBRRBR
BBBBBBBBBBBBRBBB
