RBBBRBBBBBBBBBBB
RRBRRBBBOOOBOORB
BRRRBBBBOBOBOBGB
BBRBBBBBOBOBGBGB
BBRBGGGBOBGBGBRB
BBGBGBGBOBGGGBRB
BRGBGBGBOBBBBBRB
BOBBGBGBGBBBBRRR
BOOOGBGGGBBBRRBR
BBBBBBBBBBBBRBBB
