BGGRBBBRGGGGGBBB
GGBRRBRRBBBBGBBR
GBBBRRRBBOOOGOOR
BBOBBRBOOORRGRRR
RRORRRBORRRBGBOB
RBOBBBBORBGGGBOB
RBOOBBBORBGBBBOB
RBBOBRRORGGGBOOO
RRRRRRBOGGBGOOBO
BBBOOOOOGBBBOBBB
