BBBRBBBRGGGGGBBB
BOBRRBRRGBBBGBBR
BOBBRRRBGOOOOOOR
BOOBBRBOOORRRROR
RRORRRBORRRBGBOB
RGOGGGGORBGGGBOB
RGOOBBBORBGBBBOB
RGBOBRRORGGGBOOO
RRRRRRBOGGBGOOBO
BGBOOOOOGBBBOBBB
