BBBBBBBBBBBBBBBB
BGGGGGGBOOOOOBBB
BGBBBBGBOBBBOBBB
BGBRRRRRRRBBOBBB
BGBRBBGBORBBOBBB
BGBRBBGBOOOOOBBB
BGGGGGGBBRBGGGGB
BBBRBBBBBRBGBBGB
BBBRRRRRRRBGGGGB
BBBBBBBBBBBBBBBB
