BBBBOOOOOOOBGGGB
BBBBOBBBRRORRRGR
BBGGOGBBRBOBGGGR
BBGBOGOOROOBBBBR
RRGRBGBBRGGGBBBR
RBGRGGBBRGRRRRRR
RBBRBBBBBGBGBOOO
RRRROOBBBGBGBOBO
BBBOBOBBBGBGBOBO
BBBOOOBBBGGGBOOO
