BBBBBBBBRRROOOOB
BBRRRRGGRGBORROB
GGRGBRGBRGBOOROB
GBRGBRGGGGBBBRBB
GGGGBRRRRBBBGGGB
BBRBBBBBOOOBGRGB
BRRBBBBBORORRRGB
BRBGGGGRRROBGGGB
BRRRRRGROBOBBBBB
BBBGGGGBOOOBBBBB
