BGGRRRRGGGGGGOOO
BGBRBBRBBRRRROBO
OGORBOROOOOOBOOO
OGBRRORBBRBOBRBG
OGBOBOOOOROOBRBG
OGGOGGGGGRGGGGGG
OBRRRROOOOOOBRBB
OOOOBROBBRRRRRGB
BBRBBROOOOOOGBGB
BBRRRRBBBBBBGGGB
