GGGRGGRGGRGGRGGG
GGGRGGRGGRGGRGGG
GGGRGGRGGRGGRGGG
GOOOOOOOOROOOOOG
GGGRGGRGGRGGRGGG
GGGRGGRGGRGGRGGG
GOOOOOROOOOOROOG
GGGRGGRGGRGGRGGG
GGGRGGRGGRGGRGGG
GGGRGGRGGRGGRGGG
