GGGRGGRGGRGGRGGG
GNNRNNRNNNNNRNNG
GGGRGGRGGRGGRGGG
GOOOOOROOOOOOOOG
GGGRGGRGGRGGRGGG
GGGRGGRGGRGGRGGG
GNNNNNRNNNNNRNNG
GGGRGGRGGRGGRGGG
GOOROOOOOROOOOOG
GGGRGGRGGRGGRGGG
