GGGRGGGGGRGGGGGG
GNNRNNNNNNNNRNNG
GGGRGGRGGRGGRGGG
GOOOOOROOROOOOOG
GGGRGGRGGRGGRGGG
GGGRGGRGGRGGRGGG
GOOROOOOOROOROOG
GGGRGGRGGRGGRGGG
GNNNNNRNNRNNNNNG
GGGGGGGGGRGGGGGG
