GGRGNGGRGGGRGGOG
NNRNNNNNNNNRNNNN
GGRGNGGRGGGRGGOG
OOOONOOOOOOROOOO
GGRGNGGRGGGRGGOG
GGRGNGGRGGGRGGOG
NNRNNNNRNNNNNNON
GGRGNGGRGGGRGGOG
OOOONOOROOOOOOOO
GGRGNGGRGGGRGGOG
