GGGGGGGGGRGNGNGG
GGGGGGGGGRGNGNGG
GGGGGGGGGRGNGNGG
GGGGGGGGGRGNGNGG
RRRRRRRRRRRNRRRR
GGGGGGGGGRGNGNGG
OOOOOOOOORONOOOO
GGGGGGGGGRGNGNGG
OOOOOOOOOOOOONOO
GGGGGGGGGRGNGNGG
