GGGRGGOGGGGNGRGG
OOOOOOOONNNNNNNN
GGGRGGOGGGGNGRGG
RRRRRRORRRRRRRRR
GGGRGGOGGGGNGRGG
NNNNNNNNOOONOROO
GGGRGGOGGGGNGRGG
GGGRGGOGGGGNGRGG
OOOROOOORRRNRRRR
GGGRGGOGGGGNGRGG
