RRRRRGNROORRRRGR
RRNNGRNROORRRRRR
RNRGNRNROONNRRGR
RNGRNRNRONRRNRRR
RGNNRRNRONRRNRGR
GRRRRRNRONRRNRRR
RRRRRGNGGONNRRGR
RRRRRGNGGORRRRRR
RRRRRGNGGORRRRGR
RRRRRGNGGORRRRRR
