ORRRORRRRRORNGRO
ORRRORRRORORGNRO
ROOORRRORORONGOR
RRRRRRRORORRGNRR
RRROORRORORRNGRR
RRORRORRORRRGNRR
RRORRORRRRRRNGRR
GNGNGNGNGNGNGNGN
NGNGNGNGNGNGNGNG
RRROORRRRRRRGNRR
