WBBBBBBBBBBBBBBW
WBKKBKKKBKKKBKBW
WBBKBKBKBKBKBKBW
WRRKRKRKRKRKRKRW
WRRKRKRKRKRKRKRW
WRRKRKRKRKRKRKRW
WRRKRKRKRKRKRKRW
WBBKBKBKBKBKBKBW
WBBKKKBKKKBKKKBW
WBBBBBBBBBBBBBBW
