WBBBBBBBBBBBBBBW
WBBWBWWWBWWWBWBW
WBBWBWBWBWBWBWBW
WRRKRKRKRKRKRKRW
WRRKRKRKRKRKRKRW
WRRKRKRKRKRKRKRW
WRRKRKRKRKRKRKRW
WBBWBWBWBWBWBWBW
WBBWWWBWWWBWWWBW
WBBBBBBBBBBBBBBW
