BBBBBBBBBBBBBBBB
BWWWBWWWBWWWBWWW
BWBWBWBWBWBWBWBW
RKRKRKRKRKRKRKRK
RKRKRKRKRKRKRKRK
RKRKRKRKRKRKRKRK
RKRKRKRKRKRKRKRK
BWBWBWBWBWBWBWBW
WWBWWWBWWWBWWWBW
BBBBBBBBBBBBBBBB
