WWKKKKWWWBWWWBWW
WWKWWWWWWBWWWBWW
WRKRRRRRWBWWWBWW
WWKWWBBRBBWWWBWW
WWWWWWWRWKKKKBKK
WWWWWWWRWKWWWBWW
WWWWWWWRWKWWWBWW
WWWWBBBBBBBBBBWW
WWWWWWWRWKWWWWWW
WWWWWWWWWWWWWWWW
