WWKKKKWWWBWWWBWW
WWKWWWWWWBWRRRRR
WRKRRRRRWBWRWBWW
WWKWWBBRBBWRWBWW
RWWWWWWRWKKRKKKK
RKKKKKWRWKWRWBWW
RWWWWKWRWKWWWBWW
RRRWBKBBBKBBBBWW
WWWWWKWRWKWWWWWW
WWWWWKWWWWWWWWWW
