WWKKKKWWKBWWWBWW
WWKWBBBBKKKRRRRR
WRKRBRRRWBWRWBWW
WWKWBKKRBBWRWBWW
RWWWBKWRWKKRKKKK
RKKKWWWRWKWRWBWW
RWWRRRWRWKWWWBWW
RRKWWRBBBKBBRRRW
WWKWWRWRWKWWWWRW
WWKKWRWWWWWWWWRW
