RRBBRBWWBBWBWWBB
RBWWBBWBWWBBWBWW
BBWBRRBBWBRRBBWB
WWBBRBRRBBRBRRBB
WBRRBBRBWWBBRBRR
BBRBWWBBWBWWBBRB
RRBBWBRRBBWBRRBB
RBWWBBRBWWBBRBWW
BBWBRRBBWBRRBBWB
RRBBRBWWBBRBWWBB
