RRBBRBWWWBWBWWBB
RBBBBBWBBBBBWBWW
BBBWRRBBWBRRBBWB
WWWWRBRRBBRBRRBB
WBRRBBRBWWBBRBRR
BBRBWWBBWBWWBBRB
RRBBWBRRBBWBRRWB
RBWWBBRBWWBBRBWW
BBWBRRBBWBRRBBWB
RRBBRBWWBBRWWWBB
