WWWNNNGGWYWGGNWO
WYWWNNNGGWYWGGNW
WWYWWNNNGGWYWGGN
WWWYWWNNNGGWYWGG
YWWWYWWNNNGGWYWG
YYWWWYWWNNNGGWYW
OYYWWWYWWNNNGGWY
OOYYWWWYWWNNNGGW
OOOYYWWWYWWNNNGG
OOOOYYWWWWWWNNNG
