NGNYNNWOOWWOOGGG
NGGNNNNOOOWWOOGG
NNGGNYNNWOOWWOOG
GNNGGNNNNOOOWWOO
GGNNGGNYNNWOOWWO
WGGNNGGNNNNOOOWW
WWGGNNGGNYNNWOOW
YWWGGNNGGNNNNOOO
YYWWGGNNGGNYNNWO
YYYWWGGNNGGNNNNO
