OOOOGGGGOOOOOWWW
OYYWGWWGWNNNOWWW
OWYWGWWGWNWNOWWW
OOYOOOOGONOOOWWW
YWYWGWWGWNWNWYYY
YNYNGNWGWNWNWYWY
YNYWGNGGWNGGGGGY
YNYWWNWWWNNNWYYY
YNNNNNOOWWGGGGGW
YYYWWOWOWWWWWWWW
