YYOOOWOOOWNNNNWW
YWOYOWOWOWNWWNWW
YYOYOWGGGGGGOOOO
WWOWOWGOYWYGOWWO
WWONONNGYGGGNNNO
WWONOWNWYWYWNOOO
WWWNWGNGGGYWNNNW
GGGNNGNWYYYWOOOO
GWWGWGWWNNNNOWWO
GGGGWGGGGGWNOOOO
