WGGNGGGWWWOOOWWW
WGWNWWGNNNONOWGG
NGNNWOOOOWONOYGW
WGWWWOGNONNNOWGW
WGGGGGGWOWOYOWGG
WWWWWOWWOWWYWWWY
YYYYYOYWONNNNOOO
NNNWWOYOONWYNOWY
NWNWWWYGGNNYNOWY
NYYYYYYWWGWYYYYY
