WWWWWWWWNWOWYWGW
WWWWWWWWNWOWYWGW
GGGGGGGGGGGGYGGG
WWWWWWWWNWOWYWGW
YYYYYYYYNYYYYYYY
WWWWWWWWNWOWYWGW
NNNNNNNNNNONNNGN
WWWWWWWWNWOWYWGW
OOOOOOOONOOOYOGO
WWWWWWWWNWOWYWGW
