WWGWWNWWYWWWWWGW
YYGYYYYYYYYYYYGY
WWGWWNWWYWWWWWGW
WWGWWNWWYWWWWWGW
OOOOONOOYOOOOOGO
WWGWWNWWWWWWWWGW
WWGWWWWWYWNWWWGW
OOGOOOOOOONOOOOO
WWGWWWWWYWNWWWGW
WWGWWWWWYWNWWWGW
