WWWWWNWWWWWWNWNW
OOOOWNWWWWWWNWNW
WWWWWNWWWWWWNWNW
YYYYYNYYYYYYNYYY
WWWYWNWWWWWWNWNW
WGWYWNWGWGWWNWNW
OGOYONOGOOOOOONO
WGWYWNWGWGWWNWNW
OGOOOOOOOGOYNYYY
WGWYWNWGWGWWNWNW
