FFFFFFFFFFFFFFFF
FFFFFCCCCCFFFFFF
FFFFFCFFFCFFFEEE
FEEEFCFFFCDDDEEE
FEFEDDDDDDDFDEEE
FEFEDDDDDDDFDEEE
FEEEFCFFFCDDDEEE
FFFFFCFFFCFFFEEE
FFFFFCCCCCFFFFFF
FFFFFFFFFFFFFFFF
