EEEEEFEEEEEEEEEE
EDDEEFFEEEEEEEFE
EDDCCCFEEEFEEEEE
EDDCCCDDEEEEEFEE
EDDCCCDDEEEEEEEE
EDDCCCDDEEEFEEEE
EDDCCCDDEEEEEEEE
EDDCCCFEEEFEEEFE
EDDEEFFEEEEEFEEE
EEEEEFEEEEEEEEEE
