DDDDDDDDDDDDDDDD
DCCCCCDEDEEEEEED
DCEDFCDEDEFFFFED
DCEDFCDEDEFEEFED
DCEDFCDEDEFEEFED
DCEDFCDEDEFEEFED
DCEDFCDEDEFEEFED
DCEDFCDEDEFFFFED
DCCCCCDEDEEEEEED
DDDDDDDDDDDDDDDD
