CCCCCCCCCCFFFFFF
CEEECEFFECDEEEFF
CEDEEEEEECFEFFFC
CEDDFDFDECDEFFCC
CCFEEEEEECEEEDDC
DCDEDEDEDDEDFDCC
FCCFEECCEEEEFFEC
FFCFDDCEDDEDFDCC
FCCCCCCEEECECEEC
DFFDFDCCCCCCCCCC
