EEFEFEFEFEFEFFFE
EFFFCECECECECFEE
EEFFEFEFEFEFEEFE
EFEEEEEEEEEEEFEE
EEFECFEFEFEFEEFE
EFEEFEFEFEFCEFEE
EEFEEEEEEEEEEEFE
EFEEEFEFEFEFEFEE
EEFFCECECECECFFE
EFFEFEFEFEFEFFEE
