FFEDEFFFFFFEEEFF
CCEEECCCCCCCCCCC
DCEDECDCDCDCDCDC
CCEEECCCCCCCCCCC
FFEDEFFFFFFEEEFF
FFEEEFFFFFFEFEFF
CCCCCCCCCCCEEECC
CFCFCFCFCFCEFECF
CCCCCCCCCCCEEECC
FFCCCFFFFFFEFEFF
