EEDDDEECFEEEEFEE
EDDDDDEFCEEEFFFE
EEDDDEECFEEEEFEE
EEEDEEEFCEEEEEED
FCFCFCFCFCFCFCFC
CFCFCFCFCFCFCFCF
DEEEDEECFEEEEEED
EEDEEEDFCDEEEDEE
EDEDEDECFEDEDDDE
EEDEEDEFCEDEEDEE
