FFCCDDDCFFCCCEEE
FCCDDFDCCCCDDEFE
ECEDFEDEEEDDFDEE
ECFDDEDFFEEEFDFC
ECFEFEEEEDEEFDCC
ECCECCCCCDCCCCCF
EEDDDDFEEEEEDDFF
FEEEFDEEFDDDDCFF
FFDDDDFEEEEECCCF
FFFDDFFFFFFFFCFF
