CDDCFCFFDDCDCCEC
FDFFFFFFFFFDFFFF
CDDCFCCDDCDDCEEC
CCEEFFEEDEDEEECE
EEECFFCDDCDDCEEE
CCDCFCDDCFCDCCEC
FFDFFFDFFFFDFFEF
CCDCFCDDCCFFFCEC
EEEEFEEDDECDCEEE
CDDCFCCDDEEEEEEC
