KKKWWKRWKKYYYYYY
RKRRRYYKRRKKRRRR
RWWRKKKYKKKBBBBK
RWWRRKRRRRKYYYYY
RWWWWBWWWWWWWWKR
YYYBKBWYYKKYKKKR
RRBBKBWBBBBBBBBR
RRBBWBWWKKKYYYKK
RYBBKBYYRYKWWWRK
RYKKKKKKBKKKYKRB
