KKKKWWRYRWYYYYYY
RKRRRYYRYYWWRRRR
RRKKRKKYRKKBKKKK
RWRYYYYWKBKBYRKR
RYWYYRBBBBRBKRRR
YYYWYBYRBWKKKYRR
RRBWBYBBBKKKYYRR
RRKYYWRKKYRYYBBB
RYKRKKKKKYWWWWRW
RYRKKRRKKYYRYWRW
