WKKKKWWRYRWYYYYY
RKRRYYRYYWWRRRRR
KKRKKYRKKKKKKRWR
YYYYWKBBYRKRRYWY
YRBBBBRBKRRRYYYK
YBYRBWKKYRRRRBWB
YBBBKKYYRRRRKKYW
KKKYYYBBBRYKRKKK
KYWWWWRWRYRKKRKK
YYRYWRRBBBYWKBRB
