KKKWWWBBRBYYYYYR
RWWRRWWWBRRYRRKR
RWKKRRRWWBRRRRWK
RWWBKRYWYYYYRRYR
RWBWWKYYYBWWKRRR
WBBWYKKYWWKWKRRY
WBBYYYWKKKYYRYYR
WBYYYWKYKKRRRWBB
YRYYYYWKKKKWBBBB
YRYYWRRKKYYRYWRB
