WWBBBYYKKYRBRBWB
WRWKRYYBBYYKYRRB
RRKWWWYYBBWWWWRW
WKKYWYKKYBYYYRYW
YKWRWWRBKRRRKBKB
BRYYKWWBRKRYBBWR
BBYBBWWRYYYBBBWR
RYYWBRBWWKKKBWWW
BRYYRRYBBKBBKYYK
WBYYBYYKKKBBBRRK
