KBWBBBYBYKKYRBBW
KRWBRYYBBYKYRRRR
KWWWBYBBWWWWWRWW
KWYWYKKYBYWYRYWY
YKKRWWRBKKRRKBKB
KRKYKWWBRKRYBBBW
RBBYBBWWRYYYBBBW
RYYYKBRBWWKKWBWW
BRRYRRYBBKBKKRYY
KRRYYBYYKKKBBBRR
