BRRYYBWWYBWRBYBR
BRRYYBWWYKRWRBYK
BBRYBYBWKKBRBYBK
YBWBBYKBWRKRYRKB
BWWBKKKBYRYKRYKY
RWKKKYBYBBRBYWRW
WKKKYYYBBBYWWRYB
WBBYYYRRBBYKYKRB
RYYBRRRKKYKBRYKY
RRRRRKKKKRYBRRKY
