BBRBYBKBYBWRBYBR
BBRBYBKBYBRWRBYK
RWWYBYKBRYBRBYBK
RBBYBWKWYRKRYRKB
BRYKRYYKWRYKRYKY
RKYKWWWWKBRBYWRW
RWYWKWBWBRYWWRYB
BBYWRBYKKRYKYKRB
RYKBBRYKRYKBRYKY
RYKKBBBWBRYBWRKY
